USBH_MIDI	KEYWORD1
RecvData	KEYWORD2
RecvRawData	KEYWORD2
SendData	KEYWORD2
lookupMsgSize	KEYWORD2
SendSysEx	KEYWORD2
extractSysExData	KEYWORD2
SendRawData	KEYWORD2
RcvData	KEYWORD2
SndData	KEYWORD2
ConfigureDevice	KEYWORD2
Init	KEYWORD2
Release	KEYWORD2
GetAddress	KEYWORD2
DEVCLASSOK	KEYWORD2
ACM	KEYWORD1
CDCAsyncOpeR	KEYWORD1
FTDI	KEYWORD1
FTDIAsyncOper	KEYWORD1
PL2303	KEYWORD1
SetCommFeature	KEYWORD2
GetCommFeature	KEYWORD2
ClearCommFeature	KEYWORD2
SetLineCoding	KEYWORD2
GetLineCoding	KEYWORD2
SetControlLineState	KEYWORD2
SendBreak	KEYWORD2
GetNotif	KEYWORD2
Poll	KEYWORD2
available	KEYWORD2
isReady	KEYWORD2
enhanced_status	KEYWORD2
enhanced_features	KEYWORD2
autoflowRTS	KEYWORD2
autoflowDSR	KEYWORD2
autoflowXON	KEYWORD2
half_duplex	KEYWORD2
wide	KEYWORD2
SetBaudRate	KEYWORD2
SetModemControl	KEYWORD2
SetFlowControl	KEYWORD2
SetData	KEYWORD2
EndpointXtract	KEYWORD2
VIDPIDOK	KEYWORD2
vendorRead	KEYWORD2
vendorWrite	KEYWORD2

